
-----------------------------------------------------------------------------------------------------------------------------------------------------
it is always fantasize me to handover my sexy, young and less used ( off course by me only) wife to a big monster bull... i feel thrilling when imagine to make my Hotwife dare to do Brazilian waxing. or apply good indian brand wax to remove all under..



and let go --> aur chhod do

On this sad day, let me share his a very old video to show what a NATIONALIST & PATRIOT he was. 

Turn around with azz towards camera please.
Bend over that desk again...please?

Congress leader shares pic of him hugging Hindu wife. Dares Anant Kumar Hegde to break his hands

we are "experiencing" slowness, but you can still search for friends and start conversations.

SlowDown/slump --> mandi, aarthik susti

Reminiscent--> रेमनिसन्ट --> संस्मरणशील,  समान,  याद दिलाने वाला,  बिल्कुल वैसा,  याद या स्मरण करनेवाला या करानेवाला,  अतीत का स्मरण दिलानेवाला,  स्मृति रखनेवाला,  स्मृति जगानेवाला
 this incident is reminiscent of the killing in Delhi earlier this year of a Hindu boy by the family of his Muslim girlfriend.

Throwback --> आवर्तन (m) पुनरावर्तन (m), विपर्ययण (m)
	EX --> Kohali shares throwback picture from his teenage days
	1-a reappearance of an earlier characteristic 2-an organism that has the characteristics of a more primitive type of that organism

Flashback --> पिछली कहानी ,  अतीतावलोकन ,  पूर्वदृश्य (m) ,  याद ,  स्मरण

Chronology --> घटनाक्रम, कालक्रम  
the order in which a series of events happened, or a list or explanation of these events in the order in which they happened
Ex: I'm not sure of the chronology of events.

memorate -->

Modi has given a clear message that 'Hum chhedte nahi hai, lekin kisine agar chhedha toh hum chhodhte bhi nahi hain' (We don’t trouble anyone but if someone troubles us, we don’t leave them either). We will not hesitate in taking a step when it is about national security".
 
We don’t trouble anyone but if someone troubles us, we don’t leave them: PM Modi --- 
हम किसी को छेड़ते नहीं लेकिन किसी ने हमें छेड़ा तो हम छोड़ते नहीं: पीएम मोदी 

Dog saves Pune doctor's life after cardiac arrest, "repaying him for his kindness"

vandalized--> Vehicles parked near Amit Shah's rally venue in East Midnapore, "vandalized". BJP's Rahul Sinha says, "TMC is afraid of our strength that's why they "committed" violence. Unfortunate that everything happened in front of police, attackers didn't even "spare" women workers."

Termites --> dimak

Nerdy -->  किताबी कीड़ा  "So scientists and engineers" --> You Nerdy bookworms need to stay out of politics
why are you all turning around --> ye applog sb pichhe kya dekh rhe ho
Trip Up --> Why did you trip up Deepu Singh ?--> Deepu Singh ko tangari kahe mare bhai 
watch --> Dikhaaye
Harass--> Chhedna
Thuggery --> gundagardi --> thuggery has increased in college
Hooliganism --> gundagardi
 SCATHING ---> कटु आलोचनापूर्ण  
Nail --> नेल / नैल -->  किला जड़ना,  किल ठोंकना,  आसानी से सफलता पा लेना,  कील से जड़ना,  कील से जड़ देना,  जमाना,  पकड़ना,  मारना,  लगाना,  जकड़ना,  बंद करना,  कील जड़ना,  कील लगाना,  किला ठोंकना
	Ex:  what an innings Liton is playing! First match, tons of pressure but still managed to "nail" it! "
You have hit the nail on the head, brother--> Ekdum sahi baat bol rhe hai bhaiya

Shift a little --> thoda es traf aaeye
Then get it right --> thik se kariye
Dont get into all this --> en chakkaro me mat padiye
How was your day --> baki din kaisa rha aapka
Thugs ---> gunda
You should have remained a bachelor, like Hanuman ---> rahte Hanuman ji ki trah bachelor

kept everyone safe  --> karte surksha sbki

venerate --> darshan krna
	Am I some deity that you have come to venerate? --> hum kya koi shivling hai jo hamare darshan ke liye aa gye ho

Thousands "Begin" Kisan March 2.0 from Nashik to Mumbai After Failed Late-Night Talks With Govt

Embark --> The farmers "embarked" on the 180-km march from Nashik over demands including a loan waiver and minimum support price for crops.
	Ex: Pompeo to embark on 4-nation visit from June 24-30

Embarrassing --> इम्बेरस / एम्बैरस -->   उलझाना,  घबड़ाना,  घबड़ा देना,  व्याकुल करना,  बाधा डालना,  असमंजस में डालना,  परेशान करना,  भार देना,  अड़चन डालना,  शर्मिंदा करना,  संकट में डालना,  झंझट में डालना, उलझन में डालना
	EX: Don't embarrass the newcomers.  --> नये लोगों को उलझन में मत डालो
embarrassing--> beyijjati karna, sharminda krna




backstabbing -->Malayalees have a characteristic of seeing things in a poor light, whenever another Malayalee achieves something. Malayalees have a DNA problem of backstabbing,"

Legislator --> Before contesting and winning election as an independent candidate in 2015, Anand Singh was a JDU "legislator"

Ethos --> Cultural "ethos" of Kerala is under attack by state govt: PM Modi

replete ---> भरपूर

leads to --> Shimla: Fresh snowfall "leads to" traffic congestion on National-Highway 5; #visual from Kufri. #HimachalPradesh

Step Into ---> And Once we step into this life, there is no getting out --> jis din hm es line me ghus gye na, dubara puri jindgi eske bahr nhi nikl payenge

Step Down --> Sri Lankan PM Mahinda Rajapaksa steps down amid political crisis

Step Out --> Have you ever seen me step out of line with a women --> hmko kbhi dekhe ho, kisi aurat ke sath beadbi ke sath pesh aate huwe 

Pull Up --> SC pulls up Centre on Covid vaccination policy: Key points 


Flayed --> लूटना,  तीक्ष्ण आलोचना करना,  कोड़े मारना,  चमड़ा उतारना,  खाल उतारना,  कटु आलोचना करना,  चमड़ा उतारना
our asses have been "flayed" to sit on bycycle --> sicle pr baith baith kr, hmari chutd chhil gyi hai

slam/lash-out --> तीक्ष्ण आलोचना करना
Illict --> illegal --. you are carrying illict material

Ingested --> niglna, andr le lena --> How you ingested the drug , if i say truth then swelling the drug was not easy at all.

Swallow -->niglna, andr le lena --> 3-0 loss tough to swallow but India far better side: Taylor 

Imbibe -> Nadar credited spirit of competition and self-confidence that he imbibed at the school in helping him build HCL as a tech powerhouse that currently employs 1.29 lakh employees belonging to 75 different nationalities


break-out --> clash break-out on the eve of republic day
Outbreak --> AES "outbreak": BJP's CP Thakur writes to PM, suggests setting up of biochemical lab

Loom --> लूम --> संकट मँडराना,  पास ही मंडराना,  धुंधला दिखाई देना,  अस्पष्ट देख पड़ना,  बड़ा और धुंधला दिखाई देना,  हावी होना,  सम्भावना होना
 Ex: The apex court had said the state cannot "undertake" illegal construction s with the danger of floods and heavy rain "looming" large. (ANI)

Undertaking --> उपक्रम (m),  काम (m),  कार्य (m),  प्रवृत्ति (f),  वचन (m),  व्यवसाय (m),  ज़हमत (f),  चालू करना,  वचन देना,  आरंभ करना,  दायित्व लेना,  साहय करना
The apex court had said the state cannot "undertake" illegal construction s with the danger of floods and heavy rain "looming" large. (ANI)

Undertake --> Lord Parshuram went to the Gandhamadana mountains. Over there, he "undertook" severe "penances" to please Lord Shiva.

Flog --> फ्लाग -> कोड़े मारना,  बेंत लगाना,  कोड़े लगाना     Saudi Arabia to end "flogging" as a form of punishment


Vow --> वाउ --> प्रतिज्ञा करना, क़सम खाना
	Ex: he "vowed" that he would kill the Kshatriya clan round the earth sixteen times 
debauchery --> डबॉचरी / डिबॉचरी --> ऐयाशी
	उदाहरण : वह अय्याशी में लिप्त हे
	Usage : he is indulge to debauchery


Tender -->   टेंडर देना,  चुकाना,  मान करना,  निवेदन करना,  उपस्थित करना,  प्रस्तुत करना,  पेश करना,  भेंट करना,  देना,  अदा करना,  प्रस्ताव करना,  नजर देना

Retrofit--> While the class submarine will not be equipped with an air-independent propulsion (AIP) system for the time being, there are plans to "retrofit" the boats with a domestically designed and built AIP in the coming years.

Fire Tender --> Aag bujhane wala --> 

Brake Out --> (Erupt, take place )
Ex 1-> Fire "broke out" at the 6th floor of a building in Tilak Chowk area earlier this night. No one was present in the house. "Fire tenders" present at the spot. No injuries reported. 

Ex2: Gunfight breaks out at Kulgam in Kashmir, The firefight between terrorists and security forces took place after a joint team of the police and the army cordoned off the area.

Brake Out --> Scuffle "broke out" when a primary school teach Afzal refused to sing Vande Matram on Jan 26 

Ignite --> Fire ignites in tandoori oven inside car that crashed into Adelaide business

Den--> Mand --> Tricolor flag unfurled in den of Naxal in Chhatishgarh.

Unfurl --> Tricolor flag "unfurled" in den of Naxal in Chhatishgarh.

Flags Off --> V Narayanasamy "flags off" Shramik Special train carrying 1,119 people from Puducherry


When you ride this bike, people will say "There go Kaleen Bhaiya's Men" --> espe chaloge to log kahenge ki kaleen bhaiya ke ladke ja rhe hai

They fed us too! --> wo hmlog ko khana bhi khilaye
That nearly blew my ears out --> kan ka parda fadoge mera
Dude, folks are shitting themselves here and you are worried about your ears --> yha, logo ki fatti pdi hai tum kan ko lekr chintit ho

CJI orders Rajeev Kumar to appear before CBI --> पुलिस कमिश्नर राजीव कुमार CBI के सामने पेश हों: CJI.
i told you to never call me at this number! my husband is "right here next to me" --> 
If you turn sideways-->
she looks fabulous -->



Across the river --> we have information about Naxal presence across the river.
Across -->  All educational institutions still prohibited to open across country

Dude, it's mindblowing! it makes you feel like a different person --> abe bawal chij hai , sala pura system hil jata hai
switch this off --> Damn it son, switch this off so we can talk ---> are esko band kro taki hm bat kr ske

squeezing --> Son, when you run this town, you won't be the one squeezing the trigger. --> beta , jb es shahar ko chalawoge na to gun ka trigger khud nhi dabawoge
you will need men for that.
Men who will do as they are told--> aadmi wo kre , jo tum bolo
Look, they knew you were my son --> dekho unhe pta tha, ki tum mere ladke ho
But, did they let that stop thme --> fir bhi dre tum se
spunk, spine --> They have spunk in their spine --> "guda" hai na uni "gand" me 

I want my revenge --> hme badla lena hai unse
Munna, what greater revenge is there than this --> munna esse bda bdla kya hoga

They will stay faithful to you --> we tumhare bafadar rhenge

Like Maqbool --> makbul ki trah

As faithful as Makbool was to Bauji, He has many time more faithful to me --> jitna Makbul babuji ke liye bfadar tha usse khi jyada bfadari mere liye hai

Have you ever seen him eat with us ?

Makbool is like family member, papa.
How is he family, son ? --> kahe ka family, beta
But you always ask him to eat --> lekin aap puchhte to ho
Because he never accept that.
 Then, why did you let these two sit ? --> fir en dono ko kahe baitha liye
I have just given them a morsel of respect --> baithaye nhi hai, thodi si ejjat di hai
When a man has no hope of recognition, he get it --> jb aadmi ko koi umid nhi hoti hai , aur ejjat milti hai
Then his loyalty multiplies tenfold. ---> to uski bafadari das guna bdh jati hai

That's why i am willing to wait for my inheritance. Because you are family ---> family hai esi wajah se to virasat milne ka entjar kr rhe hai
Papa, we have fixed everything --> papa, hm sb thik kr diye hai
Fixed Everything --> Sb thik kr diye hai ?
meaning ? --> matlb
We mean... Thre would not be any more trouble from kaleen bhaiya. 

--------------------------------------------------------------------------------------------------------------------------
Wishing Sambit Patra ji a speedy recovery. Take care @sambitswaraj

Narendra modi wishes Smt. Sonia Gandhi on her birthday
"Best Wishes to Smt. Sonia Gandhi ji on his birthday. I pray for her long and healthy life."

shat/shit --> fatna
Shall i tell that family that i shat myself --> kya kre, us family ko bol de ki, ft gyi hai hamari
This is wedding procession --> ye barat ka julus hai
No offence, but Phoolchand Tripathi is a pretty lame name --> 
The matter would not end here == ye bat yahi nhi khatam hogi
---------------------------------------------------------------------------------------------------------------------------------------
Process based locking --> database based --> Collection based ---> document based locking
I.T.I full form --> Industrial Training Institute

-----------------------------------------------------------------------------------------------------------------------------------------
Waive off -->Supreme Court rejects a PIL filed by lawyer Manohar Lal Sharma, seeking action against Finance Minister Arun Jaitely and alleged that he wanted to "plunder" capital reserve of RBI to "waive off" loan to certain companies. The Court has slapped a fine of Rs 50,000 on Sharma.

We have fined three more people today with this charge. But there is also a provision that the person can come to the police station and present the documents after which the fine might be "waived off"

Confiscate/attach -->   ज़ब्त कर लेना,  कुर्क करना,  जब्त करना,  ले लेना,  अधिहरण करना,  राज्याधीन कर लेना,  ज़ब्त कर लेना,  ज़ब्त करना,  ज़ब्त करना
Supreme Court issues notice to Enforcement Directorate on a plea filed by Vijay Mallya seeking stay on the proceedings initiated by the ED to declare him a fugitive economic offender and confiscate his assets. SC refuses to stay proceedings initated by the ED.

Confessed --> A 5-year-old girl's body was found in a field yesterday, in Muradnagar area. A man named Mahajan has "confessed" to rape and murder of the girl. The man has been arrested and will be produced in the court.

-------------------------------------------------------------------------------------------------------------------------------------------------


Prevail -->    जीत लेना,  प्रचलित होना,  प्रबल होना,  अभिभावी होना,  चालू होना
  Ex: प्रचलित होना - The system of shaving the hair of widows prevailed in some traditional areas of West Bengal. जीत लेना- Much to the suprise of the spectators, the amateur boxer proved that he could prevail over Bhim Singh, a veteran.

Prevail--> Imran Khan invites India for talks, says better sense should prevail

Renowned --> रिनाउन्ड --> प्रख्यात,  प्रसिद्ध,  मशहूर,  विख्यात,  विदित,  विशिष्ट,  श्रुत,  सुप्रसिद्ध,  नामवर,  नामी


RECKON --> रेककन / रेचकों / रेशकों -->  समझना (pr. {samajhana} )(Verb)
Usage : You have to reckon with our opponents
RECKON= --> रेककन / रेचकों / रेशकों --> (pr. {nirbhar hona} )(Verb)
Usage : In old days people reckoned on their sons help.

2, 7 raviwar, manalwar, pukhraj, shukr, mangal antardasha, Rahu preshani

Persist --> If the problem "persists", please try again after clearing the Temporary Files from your web browser.


Complainant --> कम्प्लेनन्ट / कम्प्लैनन्ट -->  वादी (m), शिकायतकर्ता, फ़रियादी (m), मुद्दई, शिकायत करने वाला, अभियोक्ता (m), नालिशी, परिवादी, फरियादी (m)
Accused --> अभियुक्त (also: मुलाजिम, जिस पर अपराध या दोष लगाया गया हो)
Culprit --> अभियुक्त (also: अपराधी, पापी, दोषी, वह कैदी जिस पर अपराध लगाया गया हो परंतु उसका निर्णय न हुआ हो)

Ruckus -->रखस / रखउस / रुकस ---> हंगामा,  हो हल्ला
Frenzy --> paglapan
Mischief --> क्षति, नुकसान (m), बदी (f), बुराई (f), शरारत (m), शैतानी
 The officer has been booked for forgery, use of bogus documents and fraudulently committing "mischief" of documents
Mischievousness --> मिस्चवस्नेस -->  शोख़ी, शोख़ी, दुष्ट-बुद्धि, अपकारशीलता
an attribute of mischievous children, reckless or malicious behavior that causes discomfort or annoyance in others

Misconstrue --> मिस्कन्स्ट्रू --> गलत समझना,  अशुद्ध अर्थ करना,  गलत अर्थ लगाना,  बात फेरना,  अनर्थ करना
Unlawful --> अनधिकृत,  अनुचित,  अनैतिक,  अवैध,  गैरकानूनी,  नाजायज,  ग़ैरक़ानूनी,  ग़ैरकानूनी,  नाजायज़,  नियम-विरुद्ध
	Ex--> India is yet to amend Unlawful Activities (Prevention) Act to designate

Running out --> Indicating that he was "running out" of patience with acts of indiscipline, he said, “Manmaani nahi chalegi. Whoever it may be, whoever’s son he may be... such arrogance, misbehaviour cannot be tolerated and action should be taken against them,” Modi said

Bigot --> बिगट --> कट्टर, धर्मान्ध,  पक्षपाती,  हठधर्मी, अपने मत का हठी, कट्टर व्यक्रित, धर्मांध  a person who is intolerant towards those holding different opinions
Brat --> बिगड़ैल बच्चा 
	Ex: PM Narendra Modi slams VIP brats, says bad behaviour not on
Fretful --> चिड़चिड़ा, शिकायती , तुनुकमिज़ाज   habitually complaining, nervous and unable to relax

Arrogant--> एरगन्ट / ऐरगन्ट -->  दंभी, हठी, अक्खड़, मग़रूर, हेकड़, अभिमानी, अहंकारी, घमंडी, घमण्डी

Atrocities --> अट्रासटी / अट्रासिटी -->  अत्याचार (m), क्रूरता, नृशंसता (f), महापाप (m), उद्दंडता, घोर कर्म, भारी दुष्टता, अति पाप, अतिदुष्ट व्यवहार

Wildness/arbitrariness --> आर्बट्रेरीनस -->  मनमानी, किसी के न चाहते हुए भी अपनी इच्छानुसार कोई काम आदि करने या कराने की क्रिया, जो अपने मन के अनुसार (किया गया) हो

Autocratic --> ऑटक्रैटिक --> निरंकुश,  स्वेच्छाचारी,  एकतंत्र
 EX: AIADMK acting like 'autocratic government', says Jayalalithaa's niece Deepa Jayakumar

Stubborn/admant -->  ज़िद्दी (f),  ज़िद्दी,  जकड़ा हुआ,  आंड़यल,  अड़ियल,  जिद्दी,  सख्त,  हठी,  हठीला,  अड़ियल

Goof --> गूफ --> verb(commit a faux pas or a fault or make a serious mistake) सनकी, बेवकूफ़(m), मूर्ख

Casteist --> Casteist professor who once said Twitter is ‘casteist’ for not verifying him now hails the new Twitter chief because he is a Baniya

Flout -- फलोउट / फ़्लोउट / फलॉट --------   अवहेलना, अवज्ञा करना Usage : He flouted the norms set by the society.
 Tabligi openly flout visa rules, take part in huge gatherings in the heart of the national capital and then "fan out" to every corner of India.

lewd gestures --> now some members of the Tabligi Jamaat has been found roaming naked in their ward and making "lewd gestures" for female staff at a Ghaziabad Hospital.

Notorious--> 
Rampage -->
Counterattack --> पलटवार
Trade-Off --> अदला-बदली (f),  लेन-देन (m),  समंजन (m),  समझौता (m),  सामंजस्य बैठाना

Pseudo --> सूडो --> आभासी,  कृत्रिम,  छद्म-,  झूठा,  नकली,  नक़ली,  मिथ्या,  ग़लत
	EX: Please name top five "pseudo" socialists of India  -->   कृपया भारत के शीर्षस्थ 5 "पाखंडी" समाजवादियों का नाम बताएं

Rogue -->   शरारती (m),  अज्ञानी या मूढ़ मनुष्य,  कपटी मनुष्य,  आवारा,  दुष्ट,  नटखट (m),  बदमाश (m),  शठ
Insane --> very foolish -->   उन्मत्त,  उन्मादी,  पागल,  बेसुध,  विक्षिप्त,  भ्रांतचित, पगला
carcasses --> a mob had gathered outside a police station in the city complaining that they had discovered "carcasses of cows" in their locality.
Radical--> अतिवादी,  असली,  आरम्भिक,  उग्र,  पूरा,  पूर्ण,  मूलक,  मौलिक,  विलक्षण,  समस्त,  स्वाभाविक,  जन्म का,  जड़ तक का, सुधारवादी
		Usage : "Radical" students "disrupted" the President's speech at the university.
		उदाहरण : कट्टरपंथी छात्रों ने विश्वविद्यालय में राष्ट्रपति के भाषण में खलल डाला
Disrutp --> Chinese Manja "disrupts" #DelhiMetro train service
Outfit ---> Hijbul Is terror outfit
Ruthless -->  क्रूर,  निर्दय,  निर्दयी,  निर्मोही,  निष्ठुर,  बेदर्द,  निर्मम,  करुणा शून्य
Protest --> Protestor arrested for voilanace
Pathetic --> पथेटिक -->  करुणाजनक,  दयनीय,  दीन,  निराश,  भावात्मक,  शोचनीय,  हृदयग्राही,  कारुणिक,  दिल पर असर करने वाला,  नाउम्मेद,  दिल को छूनेवाला
Silly -->   अनाड़ी,  अल्पबुद्धि,  दुर्बल,  नादान,  नासमझ,  भोंदू,  भोला,  मूर्ख,  मूर्खतापूर्ण,  मूढ़,  मतिहीन,  अल्पमति
Hypocrite-->  हिपक्रिट --->   कपटी (m),  ढोंगी (m),  पाखंडी (m),  पाखण्डी
prudish --> पाखंडी, अति संकोची, नख़रेबाज़
callous  --> कैलस --> in-sensitive कठिन,  कठोर,  निर्दय,  निर्दयी,  बेदर्द,  संवेदनाहीन,  कठोर ह्रदय,  बेरुख़,  घट्टेदार
Absurd --> अब्सर्ड / ऐब्सर्ड --> 
Anarchy/Chaos --> गड़बड़,  गड़बड़ी,  बवाल,  अराजकता,  अव्यवस्था (f),  अस्तव्यस्तता,  उथल-पुथल,  कोलाहल (m),  गड़बड़,  गड़बड़ी,  गोलमाल,  गड़बड़ी (f),  दुर्व्यवस्था अन्धव्यवस्था,  विशृंखलता,  अराजकता,  अव्यवस्था,  अस्तव्यस्तता,  उथल-पुथल

Crook -->  धोखेबाज

खलबली ----> agitation, anarchy, clatter, sensation
	Sensation --> The incident of double murder has caused a "sensation" in the area. (ANI)

Panic --> UP: Two leopards spotted in Motipur, Bahraich; create "panic"

Outcry --> हाहाकार  The 70-year-old elephant caused a social media "outcry" after being forced to take part in an annual Buddhist pageant in Sri Lanka

Havoc --> Rains wreak havoc, kill 23 in KP. Rain "wreaks havoc" in Bihar, alert in 13 districts.
 Ex: Cyclone "wreaked havoc" in the states of West Bengal and Odisha and causing loss of lives and property. 
	चक्रवात ने पश्चिम बंगाल और ओडिशा राज्यों में "कहर बरपाया" और जान-माल का नुकसान हुआ।

Delhi: Auto fare hike comes into "force today"

Instill/Infuse --> इन्स्टिल-->  सिखाना,  शिक्षा देना,  दवाई टपकाना,  बूंद-बूंद डालना,  मन में बिठा देना,  अविरत प्रयास से सिखाना,  चित्त पर प्रबाव डालना
	EX: Spirituality is something that is "instilled" deep within your soul . Delhi cop pens down poem to instil confidence, inspire people to follow lockdown

Inculcate --> इन्कल्केट--> teach and impress by frequent repetitions or admonitions --> मन में बिठाना,  मस्तिष्क में बैठा देना,  समझाना,  मन में बैठाना

Insist -->  ‘Govt trying to suppress voice of farmers amidst COVID-19 spike’: Rakesh Tikait "insists" on carrying on his drama amidst deadly pandemic

Rakes Up --> bring to light---->   उभारना,  लाना,  याद दिलाना --> Protest Against Sidhu | Congress’ Navjot Singh Sidhu (@sherryontopp) won’t condemn Pak, targets BJP, "rakes up" Kandahar incident, asks ‘who let JeM Chief go?’

Decimate --> The BJP-JD(U) alliance is all set to decimate the RJD-Congress alliance in Bihar. 


Turn Away --> Vaishnav Devi temple turns away piligramage in the wake of CORONA virus
Turn Down --> ICC turns down BCCI's demand to boycott Pakistan at the Cricket World Cup.
Turn Into --> RCEP will "turn" India into dumping ground for Chinese discards: Shatrughan Sinha.
		This feature turns your TV into a virtual music system that appears in 3 different colour tones

Turn around --> Turn Around with azz towards camera please. Turn around babe.

Rope In --> appoint  
Ex: TCIS ropes in veteran banker Ajith Somarajan as its Director

Turn off --> You turned buzzmode off? yes i did..
Stipulate --> स्टिप्यलैट-->  बंधेज करना,  अपेक्षा करना,  अनुबंध करना,  सौदा तय करना,  गारंटी देना "Agreement to finish task"
	Ex: Bharatiya Janata Party, Congress and the Communist Party of India failed to submit statements of poll expenses within the time "stipulated" by the Election Commission of India

Grope --> ग्रोप -->   ज़बर्दस्ती छूना,  किसी लड़की को ज़बर्दस्ती छूना,  किसी महिला को ज़बर्दस्ती छूना,  अंधे की तरह खोजना,  अंधेरे में टटोलना

Poke -->

Wiggle --> move to and fro --> कुलबुलाना,  छटपटाना,  हिलना,  हिलना-डुलना,  हिलाना-डुलाना,  टेढ़े-मेढ़े चलना

Wag --> matkana  -- चलना,  डोलना,  हिलाना -- Look, how she is wagging her ass.

GOI has remanded husbands in wives custody for 3 weeks.

Persist --> If the issue persists, please help us by providing the information below:

Coercive--> बलपूर्वक,रोकनेवाला, लाचारी -->  SC asks WB govt  not to take any "coercive" step against ex-IPS officer Bharati Ghosh

Batter, Deface, Maligning --> all r same

Batter --> बैटर -->  कूटना,  गिराना,  ढाना,  तोड़ना,  पीटना,  बिगाड़ना,  मारना
	EX: Heavy rain "batters" Pune, tree falls on service van of PMPML

Maligning --> मलाइन  -->   अनिष्टकर,  अहितकर,  दुष्ट,  बद,  हानिकारक,  नुक़सानदेह,  विघातक,  नुक़सान पहुंचानेवाला, verb ,  निन्दा करना,  बदनाम करना
Loiter --> लॉइटर--  देर करना,  टाल मटोल करना,  देर लगाना,  धीरे चलना,  मटरगश्ती करना,  आवारागर्दी करना,  टाल-मटोल करना
Weird --> वीयर्ड / वेयर्ड / वेर्ड -->  अजीब,  निराला , भयानक   It was a weird accident
Outrageous--> आउट्रेजस / आउट्रैजस--> अपमानजनक,  उपद्रवी,  क्रूर,  घृणित,  घोर,  बेहिसाब,  सख्त,  बेरहम,  चौंका देनेवाली,  चौंका देने वाला 
	Synonyms: grossly offensive to decency or morality; causing horror
	Ex: This is outrageous....!!! Wait till you see hope of winning...and then cry fraud. Sore losers

Outrage --> आउट्रेज / आउट्रैज -->   अत्याचार (m),  उपद्रव (m),  उल्लंघन,  बलवा,  बलात्कार,  ज़ुल्म,  नाराज़गी (f),  वीभत्सता (f),  हिंसात्मक कार्य,  बहुत खराब बात,
		verb ,  तोड़ना,  अत्याचार करना,  भंग करना,  उल्लंघन करना,  उपद्रव करना,  नाराज़ होना,  व्यतिक्रम करना
	Soniya Gandhi is shocked and outraged

BackLash --> बैक्लैश -->   पलटाव (m),  पिच्छट,  प्रतिक्षेप,  प्रतिघात (m),  फिसलना,  रपट
	Ex: Tiwari deleted the offensive tweet following a backlash

Mayhem --> मेहेम / मैहेम -->  अफरा-तफरी (f),  अशांति,  उत्पात,  खलबली (f),  बेचैनी,  मार-कूट,  मार-पीट,  लड़ाई,  हलचल,  हाथापाई,  अंगभंग

Hooligan --> हूलगन / हूलिगन --> उपद्रवी,  गुंडा (m),  गुण्डा,  बदमाश (m),  तंग करनेवाला,  उपद्रवी व्यक्ति

synergy --> सिनर्जी --> Taalmel
-----------------------------------------------------------------------------------------------------------------------------------------------
sued --> Yes King of Lies must b sued for his repeated Lying!

Gut "wrenching" images coming out of #Pulwama --> 

Uprise --> आना,  उठना,  उदय होना,  पुनर्जीवित होना,  खड़ा होना,  खड़ा हो जाना
Synonyms of uprise: arise, get up, rise, turn out, uprise, resurrect, come up, go up, lift, move up, ascend, stand up, bristle, develop, grow, originate, spring up

mumble --> मम्बल --> बुदबुदाना,  भुनभुनाना,  बड़बड़ाना,  मुंह बन्द करके खाना,  मुंह में बोलना,  ज़बान दबाकर कहना,  अस्पष्ट बोलना

Thriving --> बढ़ता,  संपन्न,  सफल,  सम्पन्न,  हरा-भरा,  बहुत फलता-फूलता,  उन्नतिशील,  फलता-फूलता
	Ex: U.S. relationship with Britain is thriving: Pompeo tells London 

Flourishing -->  पनपना,  फलना,  बढ़ना,  संवारना,  हिलाना,  सफल होना,  सुशोभित करना,  विकास पाना,  समृद्ध होना,  भाग्यवान होना,  बूटे बनाना,  हिलाना या घुमाना,  संपन्न होना,  फलना फूलना,  आडंबर दिखाना,  महत्त्व दिखलाना, अक्षर की लहर

Shower -->  Residents of Gurudwara Road in Gaya applauded sanitation workers by "showering" flower petals on them. 

fortify -->  सशक्त करना,  सुदृढ़ करना,verb ,  मजबूत,  दृढ़ करना,  दृढ़ करना,  पुष्ट करना,  किलाबंदी करना,  मजबूत करना,  मज़बूत करना,  सशक्त करना,  सुदृढ़ करना

Vigilant --> विजलन्ट --> मुस्तैद,  अनिद्र,  बिना नींद का,  एहतियाती,  चौकन्ना,  चौकस,  सचेत,  सतर्क,  सावधान,  आयुक्त् (m),  उन्निद्र,  करलेने (m),  जागरूक

Cautious --> कॉशस -> एहतियाती,  चौकन्ना,  चौकस,  बुद्धिमान,  सतर्क,  सावधान,  होशियार,  ख़बरदार,  सजग,  सावधानपूर्वक,  ख़बरदार,  दूरंदेश

courtesy and decency --> शिष्टाचार और शालीनता

Grieve --> ग्रीव --> कल्पाना,  रोना,  दुःख देना,  शोक करना,  रंज करना,  शोक पहुंचाना,  शोक मनाना,  दुःखित होना,  शोक पहुँचाना,  पीड़ा देना,  शोक मानना,  पीड़ा पाना
	EX: 8 killed in UP road mishap, CM expresses "grief"
Bereaved --> बरीव्ड-->  वंचित,  शोकसन्तप्त,  शोकार्त्त,  शोकसंतप्त,शोकसंतप्‍त --> a person who has suffered the death of someone they loved
	Ex-- Swaraj: I've asked Indian High Commissioner in Ethiopia to provide all help and assistance to the "bereaved" families.

Root Out, uproot, eleminate, empty out --> all these words are same

Consequences --> I would advice all political leaders to think deeply about the "consequences" of holding public rallies under this horrible COVID condition

reprehensible --> निन्दनीय
reconcile --> resolve, adjust --> समाधान करना, झगड़ा मिटाना, सही कर लेना

Gradually -->   धीरे धीरे,   आहिस्ता-आहिस्ता,  थोड़ा-थोड़ा

Steadily --> स्टेडली --> निरंतर, लगातार, स्थिरतापूर्वक, नियमित रूप से

development -- वृद्धि, घटनाक्रम, गतिविधि, विस्तार

chronology -- कालक्रम, घटनाक्रम, कालक्रम-निर्णय-विज्ञा

Last --> meeting lasted between pm and cm for 2 hour.


Undermine --> to make something or someone become gradually less effective, confident, or successful
Curtail --> कर्टेल / कर्टैल -->  काटना,  घटाना,  छांटना,  कम करना,  छोटा करना,  संक्षिप्त करना
	Synonyms of curtail --> curb, curtail, cut back, restrict, clip, cut short
	Janata Curfew useful step to "curtail" deadly virus spread: RS Dy Chairman
	usages: There is a need for the Reserve Bank to be more transparent on decisions like "curtailing" the term of Yes Bank's managing director

Dilute(VERB)  --> to make something less strong or effective

Lessen --> Govt must step in immediately to lessen their suffering!

Take Stock of --> PM @narendramodi to visit Odisha and West Bengal on May 28 to "take stock of" situation post-cyclone #Yaas

Oversee -->  देखरेख --> Cm Yogi has "directed" GB Nagar Dist Magistrate to "oversee" rescue & relief operations & announced that the injured be provided adequate medical aid.

In the view of --> की दृष्टि में
Hereof --> इस करण
Hereby --> इसके द्वारा
In the view of the above, you are hereby asked to show cause in writing within seven days from the receipt hereof , as to why your service would not be terminated with immediate effect for your above anti national attitude 

inevitable --> 	इनेविटबल -->   लाजमी,  जो टल न सके,  अनिवार्य,  अपरिहार्य,  अवश्य,  अवश्यंभावी,  जरूरी,  निश्चित,  अवश्यम्भावी
	Military action against Pakistan inevitable. 
  Adjective: incapable of being avoided or prevented, invariably occurring or appearing  noun: an unavoidable event

We stand in solidarity with the bereaved families --> solidarity --> एकजुटता

Brotherhood/fraternity --> भाईचारा, भ्रातृत्व, बंधुता

Stand -->  All the flight operations to North India airports to resume shortly, however, today’s all flights to Kashmir "stand" cancelled.

Stoop -->  झुकाव (m),  प्रणाम,  कमण्डल (m),  बंदगी,  कंधे झुकाकर चलना,  घर के सामने की सीढ़ी,  घर के आगे का बरामदा,  पवित्र जल का पात्र,  अपमानित होना,  छोटा बरामदा,verb ,  झुकना,  नीचे आना,  सिर झुकाना,  अधीन होना,  झपट्टा मारना,  नीचे झुकना,  नीचे गिरना, निचे  गिरना,  शरीर का झुकाव,  झुक कर चलना,  झुक कर खड़ा होना,  उतरना,  झपटना, ,  नवना,  निहुरना,  आगे की ओर झुकना या झुकाना,  चत्वर,  खुला-चबूतरा
  Ex-- Shocking to see Mr. Hegde can stoop to such level, his Muslim lady 'remark misogynistic'

"We will not "stoop down" to the level, as Modi did. The present situation is critical. It is important to "stand by" the families of martyred jawans," Pawar said.

Convoy -->    --> पथरक्षक,  पथरक्षा,  रक्षदल,  सार्थ,  सिपाहियों का दल,  रक्षा दल,  रक्षक दल (m),verb ,  रक्षार्थ साथ जाना,  चौकनी से ले जाना,  बचाने के लिये संग जाना,  साथ चलना,  चौकसी से ले जाना, रक्षार्थ

Cohesive --> Well Intigrated
-----------------------------------------------------------------------------------------------------------------------------------------------
Urging Indian Gov to look at police reforms
------------------------------------------------------------------------------------------------------------------------------------------------
Take a pledge --> I take a pledge to make India Corruption free

Bow out --> बाउ आउट --> नाम वापस लेना,  अवकाश ले लेना
	retire gracefully, remove oneself from an obligation

Bowed --> While I was growing,I always "bowed" my head in front of Mosque,Church everytime I crossed them. Though various Muslim kids refrained from singing “VandeMatram” or “Gayatri Mantra” at School.Perhaps u must b one such kid,who today desires to preach “tolerance”.

Obligation ->  अनुग्रह (m),  आबन्ध,  आभार (m),  एहसान,  कर्तव्य (m),  काम,  कार्य,  कृपा (m),  दायित्व (m)

Persuade -->  Experts says Pulwama attack shows USA has failed to persuade Pak to act against terror

Abet -->   उकसाना,  उभाड़ना,  बहकाना,  अवप्रेरित करना,  दुरुत्साहित करना,  अपराध आदि में सहायक होना,  बुरे काम के लिये उकसाना,  सहयोग देना,  बढ़ावा देना,  अपराध में सहायक होना,  सहापराध करना,दुष्प्रेरित करना
	Ex- Pakistan is a pariah nation anyhow and if it wants to exist in the real world, it should not play games, "resort to" lies, and "abet" terrorism
------------------------------------------------------------------------------------------------------------------------------------------------
set to hear --> सुनने के लिए तैयार है
constitutes --> Bhagalpur police constituted 3 member team to probe the case of alleged sexual harassment of a woman who was taking care of her #COVID19-infected husband and mother at a private hospital.

------------------------------------------------------------------------------------------------------------------------------------------------

Refute --> BSF refutes Bangladesh force claims. Refuting the BGB'S claims, the BSF asked them to indentify lapses.
Eased out -->htana --> RBI governor Urjit Patel has been "eased out" since he refused to allow the Modi govt to "plunder" Rs Three lakh crore of RBI reserves.
भारतीय रिजर्व बैंक के गवर्नर उर्जित पटेल को हटा दिया गया है क्योंकि उन्होंने मोदी सरकार को आरबीआई रिजर्व के तीन लाख करोड़ रुपये लूटने की इजाजत देने से इंकार कर दिया था।

(Fainting, dips ) ‘Doing well,’ tweets @nitin_gadkari after fainting as his sugar level dips
------------------------------------------------------------------------------------------------------------------------------------------

Screw --> Otherwise they will screw you

overhyped --> Surgical strikes politicised, "overhyped": Congress thanks General Hooda for exposing Modi. Lt Gen (retired) DS Hooda, who was the chief of the Northern Command of the Army in September 2016 during the surgical strike, said that the strikes have been politicised and overhyped.
--------------------------------------------------------------------------------------------------------------------------------------------------
PNB Complain no --> A091625227
------------------------------------------------------------------------------------------------------------------------------------------------
You haven't won the game until "you get MS Dhoni out", says James Neesham
-------------------------------------------------------------------------------------------------------------------------------------------------
Once upon a time you became mine and I became yours. And I promise we’ll stay together both through the laughter and tears. Because that’s what they call HAPPILY EVER AFTER
----------------------------------------------------------------------------------------------------------------------------------------------------
Good Morning --> from moring to 12 P:M
Good After Noon --> from 12:01 P:M to evening
Good Evening --> from 5:00 P:M on ward
-------------------------------------------------------------------------------------------------------------------------------------------------
my name is Ashutosh Kumar, I belong to Aurangabad, Bihar Or I am from Aurangabad, Bihar.
Itself --> If interviw is getting conducted/held at Aurangabad as well then i will say "mai Aurgabad ka hi hu YA mai aurangabad ka hi rhanewala hu" --> I belong to Aurangabad itself OR i am from Aurangabad itself

Conduct --> चलाना,  प्रबन्ध करना,  संचालन करना,  आचरण करना,  नेतृत्व करना,  मार्ग दिखाना,  संचालित करना,  अगुवाई करना,  निर्वाह करना,  मार्गदर्शन करना
EX: I assure the people that police, district administration, and the state government will "conduct" an unbiased investigation and the culprits will be punished, said Pilot.


Operate --> When Docs will operate the patient surgery. When NAVIC will be operational 

Stir --> स्टर --> उकसाना,  चलाना,  हिलाना,  भड़काना,  फुर्ती करना,  कार्य करना,  उत्तेजित करना
	EX: Pakistani cricketers' night out video "stirs" controversy
Stir --> स्टर --> (Verb)उकसाना, भड़काना, उत्तेजित करना (noun) तहलका,हड़बड़ी(f),हौरा,हलचल(f),सनसनी(f),विप्लव
	Ex--> Stirred by the threat of bombing

Steer--> स्टिर / स्टीर -->   मार्ग दिखाना,  हानि पहुंचाना,  परिचालन करना,  मार्गदर्शन करना,  रास्ते पर लाना,  चलाया जाना,  नुक़सान पहुंचाना,  मार्ग पर लाना,  चलाना
	EX: CWC'19: Kane Williamson "steers" New Zealand to a four-wicket victory over South Africa

The 24-hour general strike imposed by the militant party, Maoist Communist Party of Manipur paralysed normal life in the state Monday despite government’s effort to foil the strike.

We are looking through all the friednship offers

Bhindrawale is still a revered figure. No one ques Akalis.--भिंडरावाले अभी भी एक प्रतिष्ठित व्यक्ति हैं। अकालियों को कोई नहीं छोड़ता।
contemporary --> आधुनिक,  समकालीन,  समसामयिक,  सामयिक, समकालीन व्यक्ति a person of nearly the same age as another, belonging to the present time
Shah is also very affluent in literature and is known for being quite opinionated, that perhaps is what sets him apart from his contemporaries -- शाह साहित्य में भी बहुत समृद्ध हैं और काफी लोकप्रिय होने के लिए जाने जाते हैं, शायद यही बात उन्हें उनके समकालीनों से अलग करती है

Rapport --> रैपॉर / रैपोर --> सम्पर्क (m),  सौहार्द-स्थापन,  ताल्लुक़ (m),  सारूप्य,  घनिष्ठता (f),  मेल,  संबंध (m),  सद्भाव (m) - Do you feel that you have a good rapport with fellow members?

 rehabilitation --> 

Sex Worker asked to their client, where will you take me?

Ought to -->The use of ought to is similar to "should", but it is much less frequent. Like "should", the verb "ought to" does have a past form. It is only used with reference to the present and the future.

Quirk --> क्विर्क / क्विरक / क़ुईरक  --> जुगाड़ 
workarounds --> वैकल्पिक हल --(computing) A procedure or a temporary fix that bypasses a problem and allows the user to continue working until a better solution can be provided;

Lurk -->  छिपे रह कर इंतज़ार करना,  छिपा रहना,  छिप कर बैठना,  छुपा रहना,  छिपे रह कर इंतज़ार करना,  घात में होना,  घात में बैठना,  बटकना,  दुबकना,  घात में रहना --What you may not realize, though, is Google trackers are actually "lurking" behind the scenes on 75% of the top million websites

Starc to Kohli, no run, dropped. Kohli "literally" gave this away, chasing a wide one with hard hands and getting a thick outside edge. Paine dives to his right but lets it pop out with the momentum. Not a difficult grab by any means

set to --> #Train18 which is set to replace the Shatabdi series, has the potential to run between 160 kmph to 200 kmph



Bend Over --> Jhuuko

Crackdown --> कानूनी कार्यवाही , कड़ी कर्रवाई   (severely repressive actions)  My latest piece, examining #Pakistan’s latest promise of "crackdown" on Jihadi organizations, & how and why similar promises have remained unfulfilled since 9/11
	EX: Crackdown against benami property holders in budget proposed OR 
	Since protests broke out across #Egypt, the authorities have launched the largest crackdown since President @AlsisiOfficial came into power

Foster --> फास्टर / फॉस्टर --> प्रोत्साहन देना,  खिलाना,  पालना,  सहायता करना,  प्रोत्साहित करना,  प्रोत्साहन देना,  पालन-पोषण करना,  पालन पोषण करना,  दूध पिलाना,  बढ़ावा देना
EX -> use of cutting-edge technology will "foster" a tremendous growth in road & highway sector: Mr KP Maheshwari, Chairman, #FICCI Committee on Infrastructure at Roads & Highways Summit organized by @ficci_india and @NHAISocialmedia.


Estrange --> पराया,   चित फेर लेना,  दूर रखना,  दूर कर देना,  मनमुटाव पैदा करना  -- Make someone feel isolated or estranged --> किसी को पृथक या पराया महसूस कराना  
	Ex: Those of you who estrange their wives by equating them with their mothers

Notably--> नोटब्ली -->  अत्यंत,  खासकर,  निहायत,  विशेषकर,  विशेषतः,  बहुत ही
	Ex: kumar Sanu "notably" holds the Guinness World Record for most songs recorded by a singer in 24 hours with 28.[6]
Typically --> आम तौर पर
Likely -->   संभावना के साथ,adjective ,  सम्भव,  होनहार,  होनेवाला,  आशाजनक,  उपयुक्त,adverb ,  कदाचित,  संभवतः,  संभावित,  संभाव्य,  होने के योग्य,  संभावना के साथ
Better work duties are likely --> बेहतर कार्य कर्तव्यों की संभावना है।

Ascertain --> Officials said as the bodies of the troops were badly mutilated and charred due on the impact of the RDX-triggered blast, it became very difficult to "ascertain" their identities.

Please "spare" 30 second for sharing your feedback with policybazaar.
I really Banged up --> मैं वास्तव में परेशान था
Better off --> किस्मत का धनी
Least but not last --> कम से कम, लेकिन अंतिम नहीं
whoa--> वो / ह्वो / हो -->  रुको
whoops ---> ओह
Dont rush me --> मुझे जल्दी मत करो
Dang it--> धत तेरे की
Damn it--> लानत है
Yuck -- Chhi chhi

Upscale --> Can a lawsuit compel "upscale" cities to build more housing?


Arse--> आर्स --> गदहा,  गधा (m),  गुदा (f),  चूतड़,  नितंब (m)   vulgar slang for anus
Wank --> वांगक / वैंगक -->   हस्तमैथुन (m), हस्तमैथुन करना   get sexual gratification through self-stimulation
Asleep -->   निद्रा में,  मरा हुआ,  सोता हुआ,  सोया हुआ,  सोते हुए,  अचेत,  मृत,  सुन्न,  सुस्त,  सोता,  सुप्त
Intimidiate --> daraana
	EX: Centre has "intimidated" country through ED, CBI: Gehlot

The injured person has been taken to hospital OR The injured person has been rushed to hospital.

Reign --> रेन / रैन -->    फैलाव (m),  बल (m),  राज,  राजकाल,  राजत्व (m),  शासन (m),  शासनकाल (m),  हुकूमत,  राज्य शासन,  आधिपत्य करना,  राज्य-काल,  शासन-राज्य,  जोर (m),  प्रचार (m),  प्रबलता (f),  प्रभाव (m),verb ,  शासन करना,  प्रचण्ड होना,  प्रचलित होना,  राज्य करना,  छा जाना,  प्रबल होना,  हकूमत करना,  आधिपत्य करना,  मौजूद होना
Synonyms --> sovereignty, dominate, predominate, prevail, rule
Usage --> reign of terror	आतंक युग, Safety Reigns Supreme

Reinstate --> Sarthak Tripathi, 13, on Friday wrote 37th letter to Prime Minister Narendra Modi, urging him to reinstate his father - Satyajit Vijay Tripathi - a former employee of the Uttar Pradesh Stock Exchange (UPSE). 

reincarnation --> पुनर्जन्म, Avtar --> Certainly children are the reincarnation of god, was a beautiful feeling getting all the love and affection from them

incarnation --> There was a time when the world respected Pakistan, today the world doesn't have the same respect for Pakistan in its own incarnationra

Tamil Nadu: Namaz offered and fast observed for rains

Desist --> डिज़िस्ट / डिसिस्ट / डिज़िस्ट --> बंद करना,  रुक जाना,  बाज आना,  विरत होना,  हाथ उठाना,  छोड़ देना,  बंद कर देना,  परहेज करना
		Ex: #DNAPoll Do you think Trump will now "desist" from offering to mediate on J&K?


prejudice, discrimination and xenophobia --> नस्लवाद, पूर्वाग्रह, भेदभाव तथा विदेशी द्वेष
Crackdown--> कानूनी कार्यवाही, कड़ी कर्रवाई

Curb --> नियंत्रण करना ,  नियंत्रण रखना  
	Ex: Crime needs to be curbed and taught stern lesson.   Twitter is planning to "curb" the abusive tweets
	Ex: Curbs eased in Srinagar, streets remain empty. TVS Motor Company on Friday announced spending of Rs 30 crore to support the nationwide efforts to "curb" the spread of COVID-19.

Contain & Mitigate --> Our priority is to help the government efforts to "contain and mitigate" the effects of this epidemic/pandemic

Riddled --> He said the "bullet-riddled" body of Kashmiri civilian was later recovered by a search and rescue party
	Mutilated and "bullet ridden" dead bodies with hands tied found in Tral forest. Pakistan continues bloodshed through Jihad in Kashmir.

कॉर्डन एंड सर्च ऑपरेशन 

Rein --> रेन / रैन -->   थामना,  रोकना,  लगाम देना,  अधीन करना,  अधिकार में रखना,  बाग पर साधना,  लगाम खींचना,  लगाम चढ़ाना,  संयम करना
	EX: BJP Takes Fight Against Mamata to Bengal Streets, Police Use Tear Gas, Water Cannons to "Rein in" Protesters

Tightened --> Delhi: Security "tightened" in the national capital on the Republic Day

Beef Up, Tightened Up, Step Up --> all are same. Ex-> Security Beefed up in J&K

Restrain --> रिस्ट्रेन / रीस्ट्रैन -->   छेंकना,  दबाना,  रोकना,  प्रतिरोध करना,  निरोध करना,  अवरुद्ध करना,  परिमित करना,  सीमित करना,  अधीन करना,  निग्रह करना,  नियंत्रित करना,  अवरोध लगाना,  थाम रखना,  स्वतंत्रता का हनन करना
	EX-- "restrain" its rhetoric , Pepsi multinational company first filed a lawsuit in court in Ahemedabad in April and requested the court to "restrain" the four farmers from growing the FC5 potato variant. #China has criticized #America for aggravating tension in the #MiddleEast and urged all parties to exercise "restraint".
	Ex -- Live updates: Supreme Court "restrains" ED from arresting Chidambaram till Tuesday


Resist --> रिज़िस्ट / रीज़िस्ट--> रोकना,  निवारण करना,  सहन करना,  का सामना करना,  बाधा डालना,  प्रतिरोध करना,  विरोध करना,  मुकाबला करना,  अवरोध करना,  संघर्ष करना
 EX: Guru Tegh Bahadur Ji "resisted" the forced conversions of the Hindu Kashmiri Pandits[1] and non-Muslims[10] to Islam

Bridle -->  ब्राइडल -->  दबाना,  रोकना,  लगाम लगाना,  नियन्त्रण करना,  क्रुद्ध हो जाना,  लगाम देना,  क्रुद्ध होना,  नियंत्रण रखना
 EX: his common sense is a bridle to his quick temper. A man devoid of religion is like a horse without a bridle.  
		धर्महीन व्यक्ति बिना नकेल वाले घोड़े की तरह होता है।
Escalate --> after Iran officer shooting , tension esclated among middle-east 

De-escalation/Defuse --> It is imperative to take steps for "de-escalation". The United Nations must step in to 'defuse tensions", Qureshi said

Intensify --> Oil hits $70 as Iran exits nuclear deal, tensions "intensify"

Politicise --> Leave us alone, don't "politicise" our campuses, says JNU VC

Grapple -->  the act of engaging in close hand-to-hand combat  गुथना,  जुटना,  पकड़ना,  पकड़ना,  बांधना,  सामना करना,  भिड़ जाना,  कुश्ती लड़ना,  हाथापाई करना,  धर दबोचना,  तड़फड़ाना  
	EX: Rural India grapples with lack of medical facilities

Grapple --> The alleged abduction comes at a time when the world is struggling to "grapple" with the Wuhan Coronavirus pandemic unleashed by China into the world.

Acquit --> Kathua rape & murder case: Accused Vishal has been "acquitted" by the Court.

Exert--> Following the Balakot air strike by the Indian Air Force, Indian forces continued to "exert" pressure on terror groups in PoK close to the LoC.

Peddle --> Rahul Gandhi has not learnt any lesson from such a massive defeat and he is still "peddling" lies

Frame --> ‘I Am Being Framed Like #KuldeepSengar,' Says #chinmayanand On Missing Woman Case.   SC asks Centre to frame guidelines to curb social media misuse.

Scrutiny --> छानबीन
Rigorous/Stern --> कड़ी , सख्त 
Fair/Unbaised --> 
sooo your "slacking" at work huh?


Asteroid --> ऐस्टरॉइड -->क्षुद्रग्रह,  ग्रहिका (f), छोटा तारा

Deceased --> डिसीस्ट --> दिवंगत   salute to to the deceased brave man.

mystique -->

Mash-> मैश -->   कुचलना,  दलना,  मसलना,  प्रेमी बनाना --> Mash Beet"chukandar" & Potato and serve with seasoning. 
Shag -->  यौन क्रिया करना, यौन-संबंध --  let her shag your cock like that



Your loss is irreparable.

Fire rages through Hout Bay Tintswalo Resort in early morning.

President Ram Nath Kovind gives "assent" to 10% quota bill.



Hearing in SC on West Bengal CBI matter: Attorney General KK Venugopal pleads before the Supreme Court to initiate contempt of court proceedings against the alleged contemnors.

Hearing in SC on West Bengal CBI matter: Abhishek Manu Singhvi appearing for WB govt says "It's an attempt to humiliate&score point.What’s the great urgency? For 5 yrs there was no FIR. There is not a single FIR against Rajeev Kumar under 201 (Destruction of evidence) of the IPC.

Even though --> भले ही
Though ->   अगर,  मगर,  यदि,  यद्यपि,  हलांकि,  भले ही
Complies -> Match --> Ex: 06-01 ordered and on 14-01 in house Fast delivery! Top Service Product complies with the description
Although --> हालांकि
	halaki maine ek ghante pahlehi kuch khaya tha, mujhe fir se bhukh lg gyi hai
	although i ate something just an hour ago, i am hungry again

	halaki mujhe nind aa rhi thi, mai dosto ke sath bahar chala gya
	Although i was feeling sleepy, i went out with friends

Both "though" or "although" used at same place , there is no much more differences, whereas "Even though" means is same but it is big brother of "though"

Lasts --> In Siberia, winter "lasts" for seven months. That means that the ground that would become the Mir mine was frozen solid.
	http://www.postfun.com/strange/the-russian-mirny-mine-is-truly-mind-boggling



After that, they were "set to continue" mining for another 50 years. The crew had new equipment that they didn’t have when the mine first opened. They started using 20-foot tall trucks to lift rocks out of the bottom of the mine.

Be Being been
Be --> aapko drop kr diya jayega -- you will be dropped

Being --> icecream khayi ja rhi hai -- Iceceam is being eaten

Been --> motor chala di gyi hai -- motor has been switched on

On --> one can use "on" before any date or day name
At --> for specific point --> there is nail at the corner of this bench


would have --> agr maine english sikhi hoti to mujhe acchi naurkri mil jati--> if i had learnt english, i would have got a good job

Furious--.   उग्र,  क्रोधी,  जल्दबाज,  प्रकोप,  प्रचंड,  प्रचण्ड,  आगबबूला,  आपे के बाहर,  गुस्सा में,  कोपाकुल,  अति क्रुद्ध,  कोपातुर

Futile --> फ्यूटल -->  असार,  तुच्छ,  निरर्थक,  व्यर्थ,  हल्का,adjective ,  निस्सार
	Ex->  imposing mere ‘bans’ is futile   Synonyms: useless, tiny, impotent, worthless

Fragile--> फ्रैजल -->  कोमल,  दुर्बल,  फुसफुसहा,  भंगुर,  भुरभुरा,  मुलायम,  सुकुमार,  कमज़ोर,  नाज़ुक,  सहज में टूट जाने वाला,  चुरचुरा,  चुरमुरा
	Ex-> The code we developed in this chapter is somewhat fragile/vulenarable

UP Police Special Task Force busted a gang smuggling tortoises yesterday, 4 people arrested.
Varanasi: Uttar Pradesh Chief Minister Yogi Adityanath reviews preparations for 15th Pravasi Bhartiya Divas scheduled to be held from January 21 to January 23

Fierce --> फियरस--> उग्र,  उत्तेजित,  क्रुद्ध,  क्रूर,  क्रोधी,  खूँखार,  चंड,  जंगली,  तीव्र,  प्रखर,  भयंकर,  भयानक,  भारी,  भीषण,  हिंस्त्र,  अति क्रूर,  आग बबूला,  कोपाकुल
	Ex: fierce gun battle underway


Perusal --> परूज़ल --> अध्ययन,  अवलोकन (m),  देखना,  पठन (m),  परिशीलन (m),  पढ़ना (m),  वाचन,  संदर्शन (m)
	Ex--For your perusal, please find the pics of Indira Gandhi ji at Kumbh Mela in 1977.

Last Rites - Villagers did last rites of dog with full honours in Bihar

he refuses to be "cowed down" by their "tactics"


freak out	आनन्दित करना
freak out	उत्तेजित होना
freak out	मस्ती करना
noun 
freak out	धबरा जाना
freakishness	सनकीपन
FREAK= अजीब(Noun)
Usage : It was a freak accident
FREAK= अत्यधिक प्रतिक्रिया (Verb)
Usage : My friends freaked out when they saw my shaven head. When he saw the accident, he freaked out

sincere --> सिन्सिर / सिन्सीर -->  ईमानदार,  खरा,  निष्कपट,  यथार्थ,  वास्तविक,  शुद्ध,  सच्चा,  स्वच्छ,  हार्दिक,  निष्,  नेकनीयत, निष्‍ठावन

Cordially --> these 2 wifes should learn to live by the side of each other -they dont hate each other -they learn to live peacefully and cordially

Now Hang Up --> ab rkho

obscene, disgustful, wretched, odious, disgusting, yucky, miserable --> घिनौना
 
Disgusted at the cowardly terror attack on the #CRPF soldiers in #Pulwama - my sincere condolences to the families of our brave jawans. Saddened. Angry.

Numb beyond belief at the dastardly terror attack on #CRPF soldiers in #Pulwama. May God give peace to their souls, and strength to their grieving families. Wishing the injured a speedy recovery. We can’t let this be forgotten.



ripped through --> (To destroy, or to be destroyed with an explosion, blow up, explode, blow apart...) --> Idai, which struck Mozambique on March 14 and then "ripped through" Madagascar, Mozambique, Malawi and Zimbabwe, left more than 1,000 people dead. Six weeks later, Kenneth hit Comoros on April 24 and tore into Mozambique the next day. The death toll in the second cyclone is about 40.


This dirt originated from @ArvindKejriwal' brain n office it's quite similar to the alligations he had been hurling at all @INCIndia & @BJP4India Leaders in 2014 the same trick he's using again no matter if modisty of an Honorable Lady is tarnished 


Ashok Chavan,Maharashtra Congress Chief: I have submitted my resignation & now it's up to Congress President Rahul Gandhi to take call on whatever reshuffle & changes he wants to make. We fully authorise him to take call on this. I will be meeting Rahul Gandhi soon. (25.05.19)

The Tamil Nadu police have nabbed a Muslim man from Maharashtra, who was in the guise of a Hindu ‘saint’ draped in saffron clothing, at Erwadi in Ramanathapuram district in the state.

The 27-year-old man was identified as M Abdul Wahab from Sangli district in Maharashtra. Wahab was found loitering around the Erwadi Dargah, which is famous for treating mentally ill people, disguised as a Hindu sadhu.

When he visited some rural areas on Tuesday, the local people caught him on suspicion that he might have come with some ulterior motive and handed him over to the police. The police detained him for interrogation.


Superintendent of Police, Omprakash Meena, confirmed that the man was in possession of his Aadhaar card, which had the details of his name and residential address. The Tamil Nadu police have got on touch with their counterparts in Maharashtra to verify Wahab’s details. SP Meena confirmed that the future course of action will only be decided once they obtain the verification report from the Maharashtra police.

Recently, the Coimbatore city police had arrested five Muslim youths for allegedly planning to kill Hindu Makkal Katchi (HMK) leader Arjun Sampath and Sakthi Sena leader Anbu Mari.

The city police had received a tip-off from Central intelligence agencies regarding the murder plan. The Coimbatore police have arrested five Muslim youth, out of which four Muslim youths have been already on the radar of the Central intelligence agencies.

Reportedly, four out of the five arrested are from Chennai and another person is resident of Coimbatore.

Moreover, last month Tamil Nadu was put on high alert following intel that members of the Lashkar-e-Taiba had infiltrated into the state. Reports had suggested six members of the terror outfit infiltrated into the state by sea from Sri Lanka and moved to different cities, including Coimbatore, according to the police.

Security had been stepped up at many places, including airports, railway stations, bus stands and places of worship across the state. An alert had been sounded, especially in coastal districts, to prevent any further possible intrusion.

We need a shoot at sight order being issued against such bastards #TablighiJamatVirus #IndiaFightsCorona


Police is strictly enforcing weekend curfew. People who are out of their house unnecessarily are being prosecuted & cases being registered against them. I appeal to people to respect weekend curfew & stay at home and not face any trouble: Delhi Police Commissioner SN Shrivastava


Goa: A man was assaulted to death during an altercation
JP Nadda pays tribute to former President Abdul Kalam on his death anniversary

Taken into custody --> A joint team of Maharashtra ATS and Mumbai Police Crime Branch has taken a person into custody from Jogeshwari area 



